###########
# #### c###
#>     x  #
#  ##### ##
###########