############
# ### ##  ##
#>     x   #
## ###    c#
############