##########
#v     x #
#  ##    #
#####    #
#  #   c##
##########