#########
#>     x#
#  ##   #
# ###   #
###     #
# ###   #
#  #   c#
#########