########
#>     #
# ###  #
###### #
#c# #  #
#  x # #
#      #
########