##########
# x### # #
#      x #
#   ##c  #
## ###   #
#    #####
#x      <#
##########