#######
##  ###
##v c #
## ## #
#######