######
#  ###
#>  c#
### ##
######