########
#>     #
#### # #
#    # #
# ##  c#
########