#########
######  #
#>     c#
###    ##
#########