#########
#v      #
#   #   #
######  #
#  #   c#
#########