############
# v      ###
#    #   ###
# #####  ###
#   #   c###
#   x    ###
############
